County,AUN,LEA,Oct 1 Enrollment Grades 7-12,Male Dropouts,Female Dropouts,Dropouts,Dropout Rate
Adams,112011103,Bermudian Springs SD,926,2,3,5,0.54%
Adams,112011603,Conewago Valley SD,"1,825",8,6,14,0.77%
Adams,112013054,Fairfield Area SD,490,0,0,0,0.00%
Adams,112013753,Gettysburg Area SD,"1,610",8,3,11,0.68%
Adams,112015203,Littlestown Area SD,924,4,1,5,0.54%
Adams,112018523,Upper Adams SD,807,3,0,3,0.37%
Allegheny,103020603,Allegheny Valley SD,424,1,2,3,0.71%
Allegheny,103020753,Avonworth SD,773,1,2,3,0.39%
Allegheny,103021102,Baldwin-Whitehall SD,"2,094",9,2,11,0.53%
Allegheny,103021252,Bethel Park SD,"2,074",3,3,6,0.29%
Allegheny,103021453,Brentwood Borough SD,572,1,0,1,0.17%
Allegheny,103021603,Carlynton SD,589,8,0,8,1.36%
Allegheny,103021752,Chartiers Valley SD,"1,490",2,1,3,0.20%
Allegheny,102020001,City CHS,556,0,0,0,0.00%
Allegheny,103021903,Clairton City SD,323,7,3,10,3.10%
Allegheny,103022103,Cornell SD,263,0,0,0,0.00%
Allegheny,103022253,Deer Lakes SD,895,3,3,6,0.67%
Allegheny,103022803,East Allegheny SD,741,8,1,9,1.21%
Allegheny,103023153,Elizabeth Forward SD,"1,088",5,1,6,0.55%
Allegheny,199025446,Environmental Charter School at Frick Pa,155,0,0,0,0.00%
Allegheny,103023912,Fox Chapel Area SD,"1,912",1,3,4,0.21%
Allegheny,103024102,Gateway SD,"1,578",14,5,19,1.20%
Allegheny,103024603,Hampton Township SD,"1,449",3,0,3,0.21%
Allegheny,103024753,Highlands SD,"1,161",31,23,54,4.65%
Allegheny,103025002,Keystone Oaks SD,891,3,1,4,0.45%
Allegheny,102023030,Manchester Academic CS,71,0,0,0,0.00%
Allegheny,103026002,McKeesport Area SD,"1,514",30,16,46,3.04%
Allegheny,103026303,Montour SD,"1,320",3,2,5,0.38%
Allegheny,103026343,Moon Area SD,"1,784",6,3,9,0.50%
Allegheny,103026402,Mt Lebanon SD,"2,703",0,2,2,0.07%
Allegheny,103026852,North Allegheny SD,"4,093",0,0,0,0.00%
Allegheny,103026902,North Hills SD,"1,937",4,5,9,0.46%
Allegheny,103026873,Northgate SD,455,2,2,4,0.88%
Allegheny,102023217,Passport Academy CS,169,29,31,60,35.50%
Allegheny,103022481,Penn Hills Charter School of Entrepreneu,82,0,0,0,0.00%
Allegheny,103027352,Penn Hills SD,"1,689",13,10,23,1.36%
Allegheny,115220003,Pennsylvania Distance Learning CS,541,29,24,53,9.80%
Allegheny,103021003,Pine-Richland SD,"2,252",1,0,1,0.04%
Allegheny,102027451,Pittsburgh SD,"9,771",88,52,140,1.43%
Allegheny,103027503,Plum Borough SD,"1,764",5,4,9,0.51%
Allegheny,103024952,Propel CS - Hazelwood,56,0,0,0,0.00%
Allegheny,160028259,Propel CS-Braddock Hills,447,3,4,7,1.57%
Allegheny,103020005,Propel CS-East,80,0,0,0,0.00%
Allegheny,103020002,Propel CS-Homestead,272,4,3,7,2.57%
Allegheny,103020003,Propel CS-McKeesport,81,0,0,0,0.00%
Allegheny,103020004,Propel CS-Montour,222,1,4,5,2.25%
Allegheny,103028192,Propel CS-Northside,81,0,0,0,0.00%
Allegheny,103024162,Propel CS-Pitcairn,70,0,0,0,0.00%
Allegheny,103027753,Quaker Valley SD,975,0,0,0,0.00%
Allegheny,103028203,Riverview SD,414,3,3,6,1.45%
Allegheny,103028302,Shaler Area SD,"1,972",6,3,9,0.46%
Allegheny,103028653,South Allegheny SD,722,3,8,11,1.52%
Allegheny,103028703,South Fayette Township SD,"1,519",2,0,2,0.13%
Allegheny,103028753,South Park SD,872,4,0,4,0.46%
Allegheny,103023410,Spectrum CS,33,0,0,0,0.00%
Allegheny,103028833,Steel Valley SD,648,0,0,0,0.00%
Allegheny,103028853,Sto-Rox SD,524,11,3,14,2.67%
Allegheny,102020003,The New Academy CS,124,14,3,17,13.71%
Allegheny,103029203,Upper Saint Clair SD,"2,035",1,0,1,0.05%
Allegheny,102023080,Urban Pathways 6-12 CS,275,0,0,0,0.00%
Allegheny,103029403,West Allegheny SD,"1,543",1,3,4,0.26%
Allegheny,103029553,West Jefferson Hills SD,"1,392",1,1,2,0.14%
Allegheny,103029603,West Mifflin Area SD,"1,432",11,10,21,1.47%
Allegheny,103028425,Westinghouse Arts Academy CS,162,0,2,2,1.23%
Allegheny,103029902,Woodland Hills SD,"1,489",23,12,35,2.35%
Allegheny,103020368,Young Scholars of McKeesport Charter Sch,14,0,0,0,0.00%
Allegheny,103025206,Young Scholars of Western Pennsylvania C,45,0,0,0,0.00%
Armstrong,128030603,Apollo-Ridge SD,551,5,4,9,1.63%
Armstrong,128030852,Armstrong SD,"2,252",17,6,23,1.02%
Armstrong,128033053,Freeport Area SD,870,0,1,1,0.11%
Armstrong,128034503,Leechburg Area SD,349,2,3,5,1.43%
Armstrong,128034607,Lenape Tech,489,0,1,1,0.20%
Beaver,127040503,Aliquippa SD,419,2,1,3,0.72%
Beaver,127040703,Ambridge Area SD,"1,160",12,6,18,1.55%
Beaver,127041203,Beaver Area SD,"1,003",2,0,2,0.20%
Beaver,127041503,Big Beaver Falls Area SD,723,9,8,17,2.35%
Beaver,127041603,Blackhawk SD,"1,080",3,4,7,0.65%
Beaver,127042003,Central Valley SD,"1,062",5,1,6,0.56%
Beaver,127042853,Freedom Area SD,650,4,3,7,1.08%
Beaver,127044103,Hopewell Area SD,941,5,4,9,0.96%
Beaver,127040002,Lincoln Park Performing Arts CS,785,1,0,1,0.13%
Beaver,127045303,Midland Borough SD,48,0,0,0,0.00%
Beaver,127045653,New Brighton Area SD,613,5,3,8,1.31%
Beaver,127043430,Pennsylvania Cyber CS,"7,227",431,462,893,12.36%
Beaver,127045853,Riverside Beaver County SD,698,5,4,9,1.29%
Beaver,127046903,Rochester Area SD,319,1,3,4,1.25%
Beaver,127047404,South Side Area SD,490,0,1,1,0.20%
Beaver,127049303,Western Beaver County SD,321,0,1,1,0.31%
Bedford,108051003,Bedford Area SD,876,6,2,8,0.91%
Bedford,108051503,Chestnut Ridge SD,666,3,0,3,0.45%
Bedford,108053003,Everett Area SD,607,4,4,8,1.32%
Bedford,108057079,HOPE for Hyndman CS,86,2,0,2,2.33%
Bedford,108056004,Northern Bedford County SD,416,3,2,5,1.20%
Bedford,108058003,Tussey Mountain SD,394,1,1,2,0.51%
Berks,114060503,Antietam SD,508,5,6,11,2.17%
Berks,114060753,Boyertown Area SD,"3,258",10,3,13,0.40%
Berks,114060853,Brandywine Heights Area SD,693,2,2,4,0.58%
Berks,114061103,Conrad Weiser Area SD,"1,305",10,7,17,1.30%
Berks,114061503,Daniel Boone Area SD,"1,692",2,3,5,0.30%
Berks,114062003,Exeter Township SD,"1,919",18,7,25,1.30%
Berks,114062503,Fleetwood Area SD,"1,259",5,2,7,0.56%
Berks,114063003,Governor Mifflin SD,"2,109",5,10,15,0.71%
Berks,114063503,Hamburg Area SD,"1,054",3,2,5,0.47%
Berks,114060392,I-LEAD Charter School,380,42,37,79,20.79%
Berks,114064003,Kutztown Area SD,657,3,1,4,0.61%
Berks,114065503,Muhlenberg SD,"1,897",9,8,17,0.90%
Berks,114066503,Oley Valley SD,821,2,2,4,0.49%
Berks,114067002,Reading SD,"7,444",216,130,346,4.65%
Berks,114067503,Schuylkill Valley SD,971,4,0,4,0.41%
Berks,114068003,Tulpehocken Area SD,673,1,2,3,0.45%
Berks,114068103,Twin Valley SD,"1,596",8,4,12,0.75%
Berks,114069103,Wilson SD,"2,948",6,4,10,0.34%
Berks,114069353,Wyomissing Area SD,921,2,1,3,0.33%
Blair,108070502,Altoona Area SD,"3,449",48,23,71,2.06%
Blair,108071003,Bellwood-Antis SD,588,2,3,5,0.85%
Blair,108070001,Central PA Digital Learning Foundation C,112,1,3,4,3.57%
Blair,108071504,Claysburg-Kimmel SD,401,0,0,0,0.00%
Blair,108073503,Hollidaysburg Area SD,"1,665",4,10,14,0.84%
Blair,108077503,Spring Cove SD,855,1,2,3,0.35%
Blair,108078003,Tyrone Area SD,826,2,4,6,0.73%
Blair,108079004,Williamsburg Community SD,242,2,0,2,0.83%
Bradford,117080503,Athens Area SD,965,12,6,18,1.87%
Bradford,117081003,Canton Area SD,434,5,3,8,1.84%
Bradford,117083004,Northeast Bradford SD,364,0,1,1,0.27%
Bradford,117086003,Sayre Area SD,489,4,1,5,1.02%
Bradford,117086503,Towanda Area SD,690,8,6,14,2.03%
Bradford,117086653,Troy Area SD,627,16,7,23,3.67%
Bradford,117089003,Wyalusing Area SD,588,4,2,6,1.02%
Bucks,122091002,Bensalem Township SD,"3,057",34,18,52,1.70%
Bucks,122091303,Bristol Borough SD,496,2,1,3,0.60%
Bucks,122091352,Bristol Township SD,"2,654",17,12,29,1.09%
Bucks,122091457,Bucks County Technical High School,"1,424",1,0,1,0.07%
Bucks,122092002,Centennial SD,"2,672",15,7,22,0.82%
Bucks,122090001,Center for Student Learning CS at Pennsb,134,4,4,8,5.97%
Bucks,122092102,Central Bucks SD,"9,395",11,4,15,0.16%
Bucks,122092353,Council Rock SD,"5,466",6,2,8,0.15%
Bucks,122097203,Morrisville Borough SD,377,3,0,3,0.80%
Bucks,122097502,Neshaminy SD,"4,075",14,6,20,0.49%
Bucks,122097604,New Hope-Solebury SD,729,2,1,3,0.41%
Bucks,122098003,Palisades SD,812,2,6,8,0.99%
Bucks,122098103,Pennridge SD,"3,521",9,1,10,0.28%
Bucks,122098202,Pennsbury SD,"4,636",9,9,18,0.39%
Bucks,122098403,Quakertown Community SD,"2,520",11,2,13,0.52%
Bucks,122093140,School Lane CS,498,0,0,0,0.00%
Butler,104101252,Butler Area SD,"3,045",34,22,56,1.84%
Butler,104103603,Karns City Area SD,661,2,1,3,0.45%
Butler,104105003,Mars Area SD,"1,565",3,0,3,0.19%
Butler,104105353,Moniteau SD,602,4,1,5,0.83%
Butler,104107903,Seneca Valley SD,"3,517",9,7,16,0.45%
Butler,104107503,Slippery Rock Area SD,958,5,2,7,0.73%
Butler,104107803,South Butler County SD,"1,160",2,2,4,0.34%
Cambria,108110603,Blacklick Valley SD,291,4,0,4,1.37%
Cambria,108111203,Cambria Heights SD,641,2,2,4,0.62%
Cambria,108111303,Central Cambria SD,807,4,3,7,0.87%
Cambria,108111403,Conemaugh Valley SD,333,3,5,8,2.40%
Cambria,108112003,Ferndale Area SD,286,4,4,8,2.80%
Cambria,108112203,Forest Hills SD,812,2,2,4,0.49%
Cambria,108112502,Greater Johnstown SD,"1,261",12,16,28,2.22%
Cambria,108114503,Northern Cambria SD,520,2,1,3,0.58%
Cambria,108116003,Penn Cambria SD,821,0,1,1,0.12%
Cambria,108116303,Portage Area SD,438,1,1,2,0.46%
Cambria,108116503,Richland SD,741,0,1,1,0.13%
Cambria,108118503,Westmont Hilltop SD,715,0,0,0,0.00%
Cameron,109122703,Cameron County SD,232,1,0,1,0.43%
Carbon,121131507,Carbon Career & Technical Institute,393,0,0,0,0.00%
Carbon,121135003,Jim Thorpe Area SD,"1,013",2,2,4,0.39%
Carbon,121135503,Lehighton Area SD,"1,083",4,3,7,0.65%
Carbon,121136503,Palmerton Area SD,779,4,3,7,0.90%
Carbon,121136603,Panther Valley SD,698,11,9,20,2.87%
Carbon,121139004,Weatherly Area SD,303,3,1,4,1.32%
Centre,110141003,Bald Eagle Area SD,781,1,0,1,0.13%
Centre,110141103,Bellefonte Area SD,"1,279",5,5,10,0.78%
Centre,110143060,Centre Learning Community CS,46,0,0,0,0.00%
Centre,110143120,Nittany Valley CS,2,0,0,0,0.00%
Centre,110147003,Penns Valley Area SD,653,2,2,4,0.61%
Centre,110148002,State College Area SD,"3,386",6,11,17,0.50%
Centre,110140001,Young Scholars of Central PA CS,50,0,0,0,0.00%
Chester,124150002,21st Century Cyber CS,"1,162",47,70,117,10.07%
Chester,125230001,Achievement House CS,494,29,50,79,15.99%
Chester,124150003,Avon Grove CS,650,2,1,3,0.46%
Chester,124150503,Avon Grove SD,"2,560",12,8,20,0.78%
Chester,124151902,Coatesville Area SD,"2,761",13,5,18,0.65%
Chester,124153320,Collegium CS,878,1,0,1,0.11%
Chester,124152003,Downingtown Area SD,"6,408",10,5,15,0.23%
Chester,124153503,Great Valley SD,"1,977",3,0,3,0.15%
Chester,124152637,Insight PA Cyber CS,917,58,60,118,12.87%
Chester,124154003,Kennett Consolidated SD,"2,057",13,7,20,0.97%
Chester,124156503,Octorara Area SD,"1,119",4,1,5,0.45%
Chester,124156603,Owen J Roberts SD,"2,550",4,3,7,0.27%
Chester,124156703,Oxford Area SD,"1,896",9,6,15,0.79%
Chester,124150004,Pennsylvania Leadership Charter School,"2,024",38,40,78,3.85%
Chester,124157203,Phoenixville Area SD,"1,759",11,3,14,0.80%
Chester,124153350,Renaissance Academy CS,464,0,0,0,0.00%
Chester,124157802,Tredyffrin-Easttown SD,"3,428",0,0,0,0.00%
Chester,124158503,Unionville-Chadds Ford SD,"2,009",0,0,0,0.00%
Chester,124159002,West Chester Area SD,"5,678",5,7,12,0.21%
Clarion,106160303,Allegheny-Clarion Valley SD,332,1,0,1,0.30%
Clarion,106161203,Clarion Area SD,373,2,0,2,0.54%
Clarion,106161703,Clarion-Limestone Area SD,381,2,3,5,1.31%
Clarion,106166503,Keystone SD,485,1,0,1,0.21%
Clarion,106167504,North Clarion County SD,289,3,1,4,1.38%
Clarion,106168003,Redbank Valley SD,499,2,4,6,1.20%
Clarion,106169003,Union SD,242,3,0,3,1.24%
Clearfield,110171003,Clearfield Area SD,"1,013",9,11,20,1.97%
Clearfield,110171803,Curwensville Area SD,480,2,4,6,1.25%
Clearfield,106172003,Dubois Area SD,"1,576",2,10,12,0.76%
Clearfield,110173003,Glendale SD,381,1,2,3,0.79%
Clearfield,110173504,Harmony Area SD,131,0,0,0,0.00%
Clearfield,110175003,Moshannon Valley SD,414,2,1,3,0.72%
Clearfield,110177003,Philipsburg-Osceola Area SD,801,6,7,13,1.62%
Clearfield,110179003,West Branch Area SD,499,4,3,7,1.40%
Clinton,110183602,Keystone Central SD,"1,846",9,4,13,0.70%
Clinton,101833400,Sugar Valley Rural CS,228,0,0,0,0.00%
Columbia,116191004,Benton Area SD,282,1,1,2,0.71%
Columbia,116191103,Berwick Area SD,"1,214",21,13,34,2.80%
Columbia,116191203,Bloomsburg Area SD,652,4,3,7,1.07%
Columbia,116191503,Central Columbia SD,884,2,0,2,0.23%
Columbia,116191757,Columbia-Montour AVTS,637,6,4,10,1.57%
Columbia,116195004,Millville Area SD,309,1,0,1,0.32%
Columbia,116197503,Southern Columbia Area SD,648,1,1,2,0.31%
Columbia,116493130,Susq-Cyber CS,65,11,14,25,38.46%
Crawford,105201033,Conneaut SD,937,4,5,9,0.96%
Crawford,105201352,Crawford Central SD,"1,670",12,15,27,1.62%
Crawford,105204703,Penncrest SD,"1,358",6,1,7,0.52%
Cumberland,115210503,Big Spring SD,"1,195",8,0,8,0.67%
Cumberland,115211003,Camp Hill SD,636,0,0,0,0.00%
Cumberland,115211103,Carlisle Area SD,"2,357",6,10,16,0.68%
Cumberland,115211603,Cumberland Valley SD,"4,220",8,6,14,0.33%
Cumberland,115212503,East Pennsboro Area SD,"1,186",9,4,13,1.10%
Cumberland,115216503,Mechanicsburg Area SD,"1,831",4,2,6,0.33%
Cumberland,115218003,Shippensburg Area SD,"1,571",5,8,13,0.83%
Cumberland,115218303,South Middleton SD,"1,031",10,2,12,1.16%
Dauphin,115227010,Capital Area School for the Arts Charter,186,0,1,1,0.54%
Dauphin,115221402,Central Dauphin SD,"5,304",71,23,94,1.77%
Dauphin,115220002,Commonwealth Charter Academy CS,"5,925",300,332,632,10.67%
Dauphin,115221607,Dauphin County Technical School,"1,016",3,1,4,0.39%
Dauphin,115221753,Derry Township SD,"1,800",1,2,3,0.17%
Dauphin,115222504,Halifax Area SD,414,2,3,5,1.21%
Dauphin,115222752,Harrisburg City SD,"2,519",82,71,153,6.07%
Dauphin,115220001,Infinity CS,34,0,0,0,0.00%
Dauphin,115224003,Lower Dauphin SD,"1,748",8,4,12,0.69%
Dauphin,115226003,Middletown Area SD,"1,024",9,3,12,1.17%
Dauphin,115226103,Millersburg Area SD,374,6,1,7,1.87%
Dauphin,115227871,Reach Cyber CS,"1,744",62,52,114,6.54%
Dauphin,115228003,Steelton-Highspire SD,593,12,12,24,4.05%
Dauphin,115228303,Susquehanna Township SD,"1,219",4,1,5,0.41%
Dauphin,115229003,Upper Dauphin Area SD,548,1,0,1,0.18%
Delaware,125236827,Chester Charter Scholars Academy CS,289,0,0,0,0.00%
Delaware,125232950,Chester Community CS,620,3,7,10,1.61%
Delaware,125231232,Chester-Upland SD,"1,725",67,46,113,6.55%
Delaware,125231303,Chichester SD,"1,454",8,4,12,0.83%
Delaware,125234103,Garnet Valley SD,"2,389",1,0,1,0.04%
Delaware,125234502,Haverford Township SD,"2,846",5,1,6,0.21%
Delaware,125235103,Interboro SD,"1,607",11,8,19,1.18%
Delaware,125235502,Marple Newtown SD,"1,568",2,1,3,0.19%
Delaware,125236903,Penn-Delco SD,"1,568",6,0,6,0.38%
Delaware,125237603,Radnor Township SD,"1,777",1,1,2,0.11%
Delaware,125237702,Ridley SD,"2,688",5,1,6,0.22%
Delaware,125237903,Rose Tree Media SD,"1,812",1,0,1,0.06%
Delaware,125238402,Southeast Delco SD,"1,951",17,5,22,1.13%
Delaware,125238502,Springfield SD,"1,924",0,1,1,0.05%
Delaware,125239452,Upper Darby SD,"5,775",53,36,89,1.54%
Delaware,125233517,Vision Academy Charter School,36,0,0,0,0.00%
Delaware,125239603,Wallingford-Swarthmore SD,"1,745",2,1,3,0.17%
Delaware,125230002,Widener Partnership CS,56,0,0,0,0.00%
Delaware,125239652,William Penn SD,"2,230",23,20,43,1.93%
Elk,109243503,Johnsonburg Area SD,275,1,2,3,1.09%
Elk,109246003,Ridgway Area SD,359,7,4,11,3.06%
Elk,109248003,Saint Marys Area SD,987,11,9,20,2.03%
Erie,105251453,Corry Area SD,933,8,5,13,1.39%
Erie,105252602,Erie City SD,"4,637",126,82,208,4.49%
Erie,105257512,Erie Rise Leadership Academy Charter Sch,83,0,0,0,0.00%
Erie,105253303,Fairview SD,826,1,1,2,0.24%
Erie,105253553,Fort LeBoeuf SD,"1,010",2,0,2,0.20%
Erie,105253903,General McLane SD,"1,048",1,0,1,0.10%
Erie,105254053,Girard SD,759,7,1,8,1.05%
Erie,105254353,Harbor Creek SD,"1,020",2,3,5,0.49%
Erie,105256553,Iroquois SD,590,6,4,10,1.69%
Erie,105257602,Millcreek Township SD,"3,226",20,2,22,0.68%
Erie,105258303,North East SD,786,6,5,11,1.40%
Erie,105258503,Northwestern SD,653,3,3,6,0.92%
Erie,105250001,Perseus House CS of Excellence,535,24,12,36,6.73%
Erie,105252920,Robert Benjamin Wiley Community CS,93,0,0,0,0.00%
Erie,105259103,Union City Area SD,510,3,1,4,0.78%
Erie,105259703,Wattsburg Area SD,638,4,0,4,0.63%
Fayette,101260303,Albert Gallatin Area SD,"1,599",22,8,30,1.88%
Fayette,101260803,Brownsville Area SD,715,14,9,23,3.22%
Fayette,101266007,Connellsville Area Career & Technical Ce,440,1,1,2,0.45%
Fayette,101261302,Connellsville Area SD,"1,901",23,10,33,1.74%
Fayette,101262903,Frazier SD,530,4,0,4,0.75%
Fayette,101264003,Laurel Highlands SD,"1,379",10,13,23,1.67%
Fayette,101268003,Uniontown Area SD,"1,222",20,18,38,3.11%
Forest,106272003,Forest Area SD,209,0,0,0,0.00%
Franklin,112281302,Chambersburg Area SD,"4,275",54,42,96,2.25%
Franklin,112282004,Fannett-Metal SD,232,1,1,2,0.86%
Franklin,112283003,Greencastle-Antrim SD,"1,422",9,3,12,0.84%
Franklin,112286003,Tuscarora SD,"1,073",12,7,19,1.77%
Franklin,112289003,Waynesboro Area SD,"1,955",11,13,24,1.23%
Fulton,111291304,Central Fulton SD,416,3,3,6,1.44%
Fulton,111292304,Forbes Road SD,156,0,1,1,0.64%
Fulton,111297504,Southern Fulton SD,330,2,2,4,1.21%
Greene,101301303,Carmichaels Area SD,487,8,5,13,2.67%
Greene,101301403,Central Greene SD,799,10,7,17,2.13%
Greene,101303503,Jefferson-Morgan SD,320,1,3,4,1.25%
Greene,101306503,Southeastern Greene SD,265,2,4,6,2.26%
Greene,101308503,West Greene SD,307,4,2,6,1.95%
Huntingdon,111312503,Huntingdon Area SD,851,8,4,12,1.41%
Huntingdon,111312804,Juniata Valley SD,367,2,0,2,0.54%
Huntingdon,111316003,Mount Union Area SD,633,7,0,7,1.11%
Huntingdon,111440001,New Day Charter School,186,23,7,30,16.13%
Huntingdon,111317503,Southern Huntingdon County SD,526,1,2,3,0.57%
Indiana,128321103,Blairsville-Saltsburg SD,691,5,1,6,0.87%
Indiana,128323303,Homer-Center SD,412,2,1,3,0.73%
Indiana,128323703,Indiana Area SD,"1,323",8,3,11,0.83%
Indiana,128325203,Marion Center Area SD,610,4,2,6,0.98%
Indiana,128326303,Penns Manor Area SD,387,4,0,4,1.03%
Indiana,128327303,Purchase Line SD,377,3,1,4,1.06%
Indiana,128328003,United SD,492,0,2,2,0.41%
Jefferson,106330703,Brockway Area SD,442,2,1,3,0.68%
Jefferson,106330803,Brookville Area SD,689,11,5,16,2.32%
Jefferson,106333407,Jefferson County-DuBois AVTS,342,1,1,2,0.58%
Jefferson,106338003,Punxsutawney Area SD,931,12,6,18,1.93%
Juniata,111343603,Juniata County SD,"1,357",6,4,10,0.74%
Lackawanna,119350303,Abington Heights SD,"1,608",2,2,4,0.25%
Lackawanna,119351303,Carbondale Area SD,695,6,4,10,1.44%
Lackawanna,119352203,Dunmore SD,693,1,2,3,0.43%
Lackawanna,119350001,Fell CS,32,0,2,2,6.25%
Lackawanna,119355028,Howard Gardner Multiple Intelligence CS,42,0,0,0,0.00%
Lackawanna,119354603,Lakeland SD,704,0,1,1,0.14%
Lackawanna,119355503,Mid Valley SD,747,2,2,4,0.54%
Lackawanna,119356503,North Pocono SD,"1,453",3,1,4,0.28%
Lackawanna,119356603,Old Forge SD,424,1,0,1,0.24%
Lackawanna,119357003,Riverside SD,707,5,0,5,0.71%
Lackawanna,119357402,Scranton SD,"4,395",97,46,143,3.25%
Lackawanna,119358403,Valley View SD,"1,133",3,1,4,0.35%
Lancaster,113361303,Cocalico SD,"1,486",10,13,23,1.55%
Lancaster,113361503,Columbia Borough SD,562,8,6,14,2.49%
Lancaster,113361703,Conestoga Valley SD,"1,968",12,6,18,0.91%
Lancaster,113362203,Donegal SD,"1,404",7,9,16,1.14%
Lancaster,113362303,Eastern Lancaster County SD,"1,495",9,8,17,1.14%
Lancaster,113362403,Elizabethtown Area SD,"1,880",12,3,15,0.80%
Lancaster,113362603,Ephrata Area SD,"1,936",13,9,22,1.14%
Lancaster,113363103,Hempfield SD,"3,294",13,9,22,0.67%
Lancaster,113362940,La Academia Partnership Charter School,193,1,0,1,0.52%
Lancaster,113363603,Lampeter-Strasburg SD,"1,494",7,3,10,0.67%
Lancaster,113364002,Lancaster SD,"4,604",117,86,203,4.41%
Lancaster,113364403,Manheim Central SD,"1,447",18,8,26,1.80%
Lancaster,113364503,Manheim Township SD,"2,670",8,5,13,0.49%
Lancaster,113365203,Penn Manor SD,"2,515",17,12,29,1.15%
Lancaster,113365303,Pequea Valley SD,708,8,3,11,1.55%
Lancaster,113367003,Solanco SD,"1,632",8,8,16,0.98%
Lancaster,113369003,Warwick SD,"1,993",7,9,16,0.80%
Lawrence,104372003,Ellwood City Area SD,734,4,0,4,0.54%
Lawrence,104374003,Laurel SD,523,0,0,0,0.00%
Lawrence,104374207,Lawrence County CTC,367,2,0,2,0.54%
Lawrence,104375003,Mohawk Area SD,640,0,0,0,0.00%
Lawrence,104375203,Neshannock Township SD,578,0,0,0,0.00%
Lawrence,104375302,New Castle Area SD,"1,273",7,7,14,1.10%
Lawrence,104376203,Shenango Area SD,504,2,1,3,0.60%
Lawrence,104377003,Union Area SD,317,0,0,0,0.00%
Lawrence,104378003,Wilmington Area SD,553,1,1,2,0.36%
Lebanon,113380303,Annville-Cleona SD,703,5,2,7,1.00%
Lebanon,113381303,Cornwall-Lebanon SD,"2,318",9,8,17,0.73%
Lebanon,113382303,Eastern Lebanon County SD,"1,106",10,5,15,1.36%
Lebanon,113384603,Lebanon SD,"2,116",50,26,76,3.59%
Lebanon,113385003,Northern Lebanon SD,"1,040",14,7,21,2.02%
Lebanon,113385303,Palmyra Area SD,"1,755",11,6,17,0.97%
Lehigh,121390302,Allentown City SD,"7,524",235,122,357,4.74%
Lehigh,121395927,Arts Academy CS,230,0,0,0,0.00%
Lehigh,121391303,Catasauqua Area SD,705,6,3,9,1.28%
Lehigh,121394017,Circle of Seasons Charter School,20,0,0,0,0.00%
Lehigh,121392303,East Penn SD,"4,152",15,2,17,0.41%
Lehigh,121398065,Executive Education Academy Charter Scho,570,4,0,4,0.70%
Lehigh,121395526,Innovative Arts Academy CS,471,6,8,14,2.97%
Lehigh,175390169,Lincoln Leadership Academy Charter Schoo,343,0,0,0,0.00%
Lehigh,121394503,Northern Lehigh SD,733,9,1,10,1.36%
Lehigh,121394603,Northwestern Lehigh SD,"1,114",0,0,0,0.00%
Lehigh,121395103,Parkland SD,"4,725",10,5,15,0.32%
Lehigh,121393330,Roberto Clemente CS,256,0,0,0,0.00%
Lehigh,121395603,Salisbury Township SD,797,3,0,3,0.38%
Lehigh,121395703,Southern Lehigh SD,"1,641",4,0,4,0.24%
Lehigh,121397803,Whitehall-Coplay SD,"2,171",6,3,9,0.41%
Luzerne,118400001,Bear Creek Community CS,102,0,0,0,0.00%
Luzerne,118401403,Crestwood SD,"1,351",4,3,7,0.52%
Luzerne,118401603,Dallas SD,"1,210",6,2,8,0.66%
Luzerne,118402603,Greater Nanticoke Area SD,"1,080",11,14,25,2.31%
Luzerne,118403003,Hanover Area SD,936,3,3,6,0.64%
Luzerne,118403302,Hazleton Area SD,"5,275",129,82,211,4.00%
Luzerne,118403903,Lake-Lehman SD,868,6,2,8,0.92%
Luzerne,118406003,Northwest Area SD,480,0,3,3,0.63%
Luzerne,118406602,Pittston Area SD,"1,553",6,7,13,0.84%
Luzerne,118408707,West Side CTC,561,4,2,6,1.07%
Luzerne,118408852,Wilkes-Barre Area SD,"3,268",54,32,86,2.63%
Luzerne,118409203,Wyoming Area SD,"1,027",3,3,6,0.58%
Luzerne,118409302,Wyoming Valley West SD,"1,974",15,13,28,1.42%
Lycoming,117412003,East Lycoming SD,745,3,5,8,1.07%
Lycoming,117414003,Jersey Shore Area SD,"1,112",15,6,21,1.89%
Lycoming,117414203,Loyalsock Township SD,741,5,2,7,0.94%
Lycoming,117415004,Montgomery Area SD,380,1,0,1,0.26%
Lycoming,117415103,Montoursville Area SD,924,6,4,10,1.08%
Lycoming,117415303,Muncy SD,475,2,0,2,0.42%
Lycoming,117416103,South Williamsport Area SD,591,6,0,6,1.02%
Lycoming,117417202,Williamsport Area SD,"2,258",35,16,51,2.26%
McKean,109420803,Bradford Area SD,"1,144",8,12,20,1.75%
McKean,109422303,Kane Area SD,552,5,2,7,1.27%
McKean,109426003,Otto-Eldred SD,312,0,0,0,0.00%
McKean,109426303,Port Allegany SD,371,2,0,2,0.54%
McKean,109427503,Smethport Area SD,370,3,0,3,0.81%
Mercer,104431304,Commodore Perry SD,211,0,0,0,0.00%
Mercer,104432503,Farrell Area SD,294,7,4,11,3.74%
Mercer,104432803,Greenville Area SD,637,2,0,2,0.31%
Mercer,104432903,Grove City Area SD,"1,256",5,4,9,0.72%
Mercer,104433303,Hermitage SD,986,4,2,6,0.61%
Mercer,104433604,Jamestown Area SD,237,0,0,0,0.00%
Mercer,104432830,Keystone Education Center CS,201,6,7,13,6.47%
Mercer,104433903,Lakeview SD,503,1,0,1,0.20%
Mercer,104435003,Mercer Area SD,488,6,0,6,1.23%
Mercer,104435303,Reynolds SD,505,0,0,0,0.00%
Mercer,104435603,Sharon City SD,822,8,6,14,1.70%
Mercer,104435703,Sharpsville Area SD,590,4,2,6,1.02%
Mercer,104437503,West Middlesex Area SD,423,2,1,3,0.71%
Mifflin,111444602,Mifflin County SD,"2,363",23,8,31,1.31%
Monroe,120452003,East Stroudsburg Area SD,"3,365",21,10,31,0.92%
Monroe,120450003,Evergreen Community CS,89,0,0,0,0.00%
Monroe,120455203,Pleasant Valley SD,"2,303",21,8,29,1.26%
Monroe,120455403,Pocono Mountain SD,"4,406",27,17,44,1.00%
Monroe,120456003,Stroudsburg Area SD,"2,545",16,13,29,1.14%
Montgomery,123460302,Abington SD,"3,768",9,6,15,0.40%
Montgomery,126510020,Agora Cyber CS,"3,853",257,259,516,13.39%
Montgomery,123461302,Cheltenham SD,"1,990",4,4,8,0.40%
Montgomery,123461602,Colonial SD,"2,237",5,4,9,0.40%
Montgomery,123463603,Hatboro-Horsham SD,"2,300",4,3,7,0.30%
Montgomery,123463803,Jenkintown SD,331,0,0,0,0.00%
Montgomery,123464502,Lower Merion SD,"4,139",2,0,2,0.05%
Montgomery,123464603,Lower Moreland Township SD,"1,149",1,1,2,0.17%
Montgomery,123465303,Methacton SD,"2,308",6,0,6,0.26%
Montgomery,123465602,Norristown Area SD,"3,086",45,44,89,2.88%
Montgomery,123465702,North Penn SD,"6,196",18,8,26,0.42%
Montgomery,123460001,Pennsylvania Virtual CS,"1,243",11,18,29,2.33%
Montgomery,123466103,Perkiomen Valley SD,"2,738",2,0,2,0.07%
Montgomery,123466303,Pottsgrove SD,"1,478",9,6,15,1.01%
Montgomery,123466403,Pottstown SD,"1,301",27,22,49,3.77%
Montgomery,123467103,Souderton Area SD,"3,233",17,9,26,0.80%
Montgomery,123463370,Souderton CS Collaborative,40,0,0,0,0.00%
Montgomery,123467303,Spring-Ford Area SD,"3,815",6,3,9,0.24%
Montgomery,123467203,Springfield Township SD,"1,105",2,0,2,0.18%
Montgomery,123468303,Upper Dublin SD,"1,952",0,0,0,0.00%
Montgomery,123468402,Upper Merion Area SD,"1,881",12,2,14,0.74%
Montgomery,123468503,Upper Moreland Township SD,"1,381",3,3,6,0.43%
Montgomery,123468603,Upper Perkiomen SD,"1,535",6,4,10,0.65%
Montgomery,123469303,Wissahickon SD,"2,137",1,2,3,0.14%
Montour,116471803,Danville Area SD,"1,038",7,1,8,0.77%
Northampton,120480803,Bangor Area SD,"1,450",13,5,18,1.24%
Northampton,120481002,Bethlehem Area SD,"6,740",83,41,124,1.84%
Northampton,120483302,Easton Area SD,"4,240",25,14,39,0.92%
Northampton,120480002,Lehigh Valley Academy Regional CS,703,0,0,0,0.00%
Northampton,120483170,Lehigh Valley Charter High School for th,631,1,0,1,0.16%
Northampton,139481451,Lehigh Valley Dual Language Charter Scho,85,0,0,0,0.00%
Northampton,120484803,Nazareth Area SD,"2,314",10,4,14,0.61%
Northampton,120484903,Northampton Area SD,"2,775",17,14,31,1.12%
Northampton,120485603,Pen Argyl Area SD,786,6,5,11,1.40%
Northampton,120486003,Saucon Valley SD,"1,089",1,1,2,0.18%
Northampton,120488603,Wilson Area SD,"1,093",3,5,8,0.73%
Northumberland,116493503,Line Mountain SD,544,2,4,6,1.10%
Northumberland,116495003,Milton Area SD,966,5,5,10,1.04%
Northumberland,116495103,Mount Carmel Area SD,663,6,8,14,2.11%
Northumberland,116496503,Shamokin Area SD,"1,061",10,12,22,2.07%
Northumberland,116496603,Shikellamy SD,"1,259",28,23,51,4.05%
Northumberland,116498003,Warrior Run SD,743,6,3,9,1.21%
Perry,115503004,Greenwood SD,362,0,0,0,0.00%
Perry,115504003,Newport SD,501,6,1,7,1.40%
Perry,115506003,Susquenita SD,740,3,4,7,0.95%
Perry,115508003,West Perry SD,"1,098",5,3,8,0.73%
Philadelphia,126514368,ACT Academy Cyber CS,76,2,0,2,2.63%
Philadelphia,126510015,Ad Prima CS,120,0,0,0,0.00%
Philadelphia,126512990,Alliance for Progress CS,107,0,0,0,0.00%
Philadelphia,104510394,Antonia Pantoja Community Charter School,140,0,0,0,0.00%
Philadelphia,181519176,ASPIRA Bilingual Cyber Charter School,275,16,15,31,11.27%
Philadelphia,126510010,Belmont Charter School,244,0,1,1,0.41%
Philadelphia,185515523,Boys Latin of Philadelphia CS,688,0,0,0,0.00%
Philadelphia,126513190,Charter High School for Architecture and,614,0,0,0,0.00%
Philadelphia,126513160,Christopher Columbus CS,176,0,0,0,0.00%
Philadelphia,126512840,Community Academy of Philadelphia CS,734,5,1,6,0.82%
Philadelphia,126510011,Discovery Charter School,136,0,0,0,0.00%
Philadelphia,177518712,Eastern University Academy Charter Schoo,274,0,0,0,0.00%
Philadelphia,126513440,Esperanza Academy Charter School,"1,208",4,3,7,0.58%
Philadelphia,126511563,Esperanza Cyber CS,281,22,14,36,12.81%
Philadelphia,126513100,Eugenio Maria De Hostos CS,159,0,0,0,0.00%
Philadelphia,100510000,First Philadelphia Preparatory Charter S,722,2,1,3,0.42%
Philadelphia,126510021,Folk Arts-Cultural Treasures CS,122,0,0,0,0.00%
Philadelphia,147513703,Franklin Towne Charter Elementary School,209,0,0,0,0.00%
Philadelphia,126513450,Franklin Towne CHS,"1,222",3,2,5,0.41%
Philadelphia,126518547,Frederick Douglass Mastery Charter Schoo,156,0,0,0,0.00%
Philadelphia,126513270,Freire CS,748,2,2,4,0.53%
Philadelphia,126513380,Global Leadership Academy CS,147,0,0,0,0.00%
Philadelphia,126518004,Global Leadership Academy CS Southwest a,96,0,0,0,0.00%
Philadelphia,126510005,Green Woods CS,121,0,0,0,0.00%
Philadelphia,126512850,Harambee Institute of Science and Techno,100,0,1,1,1.00%
Philadelphia,126512980,Imhotep Institute CHS,597,0,0,0,0.00%
Philadelphia,126513510,Independence CS,158,0,0,0,0.00%
Philadelphia,133513315,John B Stetson Charter School,503,6,9,15,2.98%
Philadelphia,182514568,Keystone Academy Charter School,145,0,1,1,0.69%
Philadelphia,126510017,Khepera CS,68,0,0,0,0.00%
Philadelphia,126514864,KIPP DuBois Charter School,519,1,2,3,0.58%
Philadelphia,126510013,KIPP Philadelphia Charter School,172,0,0,0,0.00%
Philadelphia,172510793,KIPP West Philadelphia Preparatory Chart,181,0,1,1,0.55%
Philadelphia,126513110,Laboratory CS,92,0,0,0,0.00%
Philadelphia,126519476,Lindley Academy CS at Birney,147,0,0,0,0.00%
Philadelphia,126513480,Mariana Bracetti Academy CS,659,2,1,3,0.46%
Philadelphia,126510014,Maritime Academy Charter School,449,1,1,2,0.45%
Philadelphia,126513150,MAST Community CS,665,0,0,0,0.00%
Philadelphia,126510002,Mastery CHS - Lenfest Campus,577,3,0,3,0.52%
Philadelphia,126519644,Mastery CS - Cleveland Elementary,163,0,0,0,0.00%
Philadelphia,126518795,Mastery CS - Francis D. Pastorius Elemen,109,0,0,0,0.00%
Philadelphia,126513290,Mastery CS - Hardy Williams,653,3,3,6,0.92%
Philadelphia,126513734,Mastery CS-Gratz Campus,"1,414",15,9,24,1.70%
Philadelphia,126516457,Mastery CS-Harrity Campus,165,0,0,0,0.00%
Philadelphia,151514721,Mastery CS-Pickett Campus,744,1,0,1,0.13%
Philadelphia,126510022,Mastery CS-Shoemaker Campus,777,4,1,5,0.64%
Philadelphia,126510023,Mastery CS-Thomas Campus,687,3,1,4,0.58%
Philadelphia,126513230,Math Civics and Sciences CS,492,0,0,0,0.00%
Philadelphia,126519392,Memphis Street Academy CS @ JP Jones,439,0,0,0,0.00%
Philadelphia,126513000,Multicultural Academy CS,273,0,0,0,0.00%
Philadelphia,126513420,New Foundations CS,950,0,0,0,0.00%
Philadelphia,126510019,Northwood Academy CS,165,0,0,0,0.00%
Philadelphia,126513452,Olney Charter High School,"1,823",109,70,179,9.82%
Philadelphia,173515368,Pan American Academy CS,119,0,0,0,0.00%
Philadelphia,126510004,People for People CS,194,0,0,0,0.00%
Philadelphia,126513280,Philadelphia Academy CS,612,0,3,3,0.49%
Philadelphia,126515001,Philadelphia City SD,"56,012","1,776","1,253","3,029",5.41%
Philadelphia,126510009,Philadelphia Electrical & Tech CHS,600,0,3,3,0.50%
Philadelphia,126513400,Philadelphia Performing Arts CS,"1,033",0,0,0,0.00%
Philadelphia,126512960,Preparatory CS of Mathematics Science Te,631,0,0,0,0.00%
Philadelphia,126510008,Richard Allen Preparatory CS,265,0,0,0,0.00%
Philadelphia,126510001,Russell Byers CS,98,0,0,0,0.00%
Philadelphia,114514135,Sankofa Freedom Academy Charter School,289,0,0,0,0.00%
Philadelphia,108515107,Southwest Leadership Academy CS,115,0,0,0,0.00%
Philadelphia,192518422,Tacony Academy Charter School,542,6,3,9,1.66%
Philadelphia,126511530,TECH Freire CS,490,5,2,7,1.43%
Philadelphia,126515691,The Philadelphia CS for Arts and Science,217,0,0,0,0.00%
Philadelphia,126512674,Universal Alcorn CS,89,0,0,0,0.00%
Philadelphia,126519434,Universal Audenried Charter School,518,14,21,35,6.76%
Philadelphia,126517442,Universal Creighton Charter School,168,0,0,0,0.00%
Philadelphia,103519376,Universal Daroff Charter School,115,0,2,2,1.74%
Philadelphia,126513210,Universal Institute CS,119,0,1,1,0.84%
Philadelphia,126513415,Universal Vare Charter School,173,5,0,5,2.89%
Philadelphia,126513020,West Oak Lane CS,187,0,0,0,0.00%
Philadelphia,126510007,Wissahickon CS,204,0,0,0,0.00%
Philadelphia,126513250,Young Scholars CS,185,0,0,0,0.00%
Philadelphia,126512870,Youth Build Phila CS,225,34,48,82,36.44%
Pike,120522003,Delaware Valley SD,"2,252",11,3,14,0.62%
Pike,119648303,Wallenpaupack Area SD,"1,478",7,1,8,0.54%
Potter,109530304,Austin Area SD,85,0,0,0,0.00%
Potter,109531304,Coudersport Area SD,368,5,0,5,1.36%
Potter,109532804,Galeton Area SD,154,2,1,3,1.95%
Potter,109535504,Northern Potter SD,221,0,0,0,0.00%
Potter,109537504,Oswayo Valley SD,177,2,0,2,1.13%
Schuylkill,129540803,Blue Mountain SD,"1,337",3,6,9,0.67%
Schuylkill,129544907,Gillingham Charter School,113,0,0,0,0.00%
Schuylkill,129544503,Mahanoy Area SD,457,7,3,10,2.19%
Schuylkill,129544703,Minersville Area SD,513,2,1,3,0.58%
Schuylkill,129545003,North Schuylkill SD,944,9,6,15,1.59%
Schuylkill,129546003,Pine Grove Area SD,771,8,2,10,1.30%
Schuylkill,129546103,Pottsville Area SD,"1,337",24,11,35,2.62%
Schuylkill,129546803,Saint Clair Area SD,116,0,0,0,0.00%
Schuylkill,129547303,Schuylkill Haven Area SD,586,6,1,7,1.19%
Schuylkill,129547203,Shenandoah Valley SD,485,6,3,9,1.86%
Schuylkill,129547603,Tamaqua Area SD,"1,018",8,5,13,1.28%
Schuylkill,129547803,Tri-Valley SD,388,2,0,2,0.52%
Schuylkill,129548803,Williams Valley SD,464,4,1,5,1.08%
Snyder,116555003,Midd-West SD,"1,009",8,4,12,1.19%
Snyder,116557103,Selinsgrove Area SD,"1,324",19,7,26,1.96%
Somerset,108561003,Berlin Brothersvalley SD,330,0,0,0,0.00%
Somerset,108561803,Conemaugh Township Area SD,455,4,1,5,1.10%
Somerset,108565203,Meyersdale Area SD,427,2,1,3,0.70%
Somerset,108565503,North Star SD,485,4,4,8,1.65%
Somerset,108566303,Rockwood Area SD,364,3,0,3,0.82%
Somerset,108567004,Salisbury-Elk Lick SD,109,0,0,0,0.00%
Somerset,108567204,Shade-Central City SD,221,1,0,1,0.45%
Somerset,108567404,Shanksville-Stonycreek SD,149,0,0,0,0.00%
Somerset,108567703,Somerset Area SD,"1,006",11,4,15,1.49%
Somerset,108568404,Turkeyfoot Valley Area SD,140,1,2,3,2.14%
Somerset,108569103,Windber Area SD,535,1,0,1,0.19%
Sullivan,117576303,Sullivan County SD,283,0,1,1,0.35%
Susquehanna,119581003,Blue Ridge SD,416,1,3,4,0.96%
Susquehanna,119582503,Elk Lake SD,518,1,0,1,0.19%
Susquehanna,119583003,Forest City Regional SD,349,1,0,1,0.29%
Susquehanna,119584503,Montrose Area SD,618,2,4,6,0.97%
Susquehanna,119584603,Mountain View SD,428,3,1,4,0.93%
Susquehanna,119586503,Susquehanna Community SD,342,1,0,1,0.29%
Tioga,117596003,Northern Tioga SD,939,9,3,12,1.28%
Tioga,117597003,Southern Tioga SD,883,0,2,2,0.23%
Tioga,117598503,Wellsboro Area SD,712,3,7,10,1.40%
Union,116604003,Lewisburg Area SD,942,1,0,1,0.11%
Union,116605003,Mifflinburg Area SD,"1,023",6,5,11,1.08%
Venango,106611303,Cranberry Area SD,509,4,0,4,0.79%
Venango,106612203,Franklin Area SD,856,6,3,9,1.05%
Venango,106616203,Oil City Area SD,898,11,2,13,1.45%
Venango,106617203,Titusville Area SD,839,4,2,6,0.72%
Venango,106618603,Valley Grove SD,433,2,2,4,0.92%
Warren,105620001,Tidioute Community CS,144,0,0,0,0.00%
Warren,105628302,Warren County SD,"2,070",20,15,35,1.69%
Washington,101630504,Avella Area SD,259,1,1,2,0.77%
Washington,101630903,Bentworth SD,549,3,1,4,0.73%
Washington,101631003,Bethlehem-Center SD,569,3,5,8,1.41%
Washington,101631203,Burgettstown Area SD,504,9,5,14,2.78%
Washington,101631503,California Area SD,404,4,1,5,1.24%
Washington,101631703,Canon-McMillan SD,"2,485",1,2,3,0.12%
Washington,101631803,Charleroi SD,702,11,8,19,2.71%
Washington,101631903,Chartiers-Houston SD,516,4,2,6,1.16%
Washington,101632403,Fort Cherry SD,508,5,0,5,0.98%
Washington,101633903,McGuffey SD,726,6,3,9,1.24%
Washington,101636503,Peters Township SD,"2,044",0,1,1,0.05%
Washington,101637002,Ringgold SD,"1,315",9,0,9,0.68%
Washington,101638003,Trinity Area SD,"1,493",6,7,13,0.87%
Washington,101638803,Washington SD,623,10,6,16,2.57%
Wayne,119648703,Wayne Highlands SD,"1,186",13,3,16,1.35%
Wayne,119648903,Western Wayne SD,884,4,2,6,0.68%
Westmoreland,107650603,Belle Vernon Area SD,"1,147",2,6,8,0.70%
Westmoreland,107650703,Burrell SD,896,6,3,9,1.00%
Westmoreland,107651603,Derry Area SD,909,5,3,8,0.88%
Westmoreland,107653040,Dr Robert Ketterer CS Inc,198,7,2,9,4.55%
Westmoreland,107652603,Franklin Regional SD,"1,721",1,1,2,0.12%
Westmoreland,107653102,Greater Latrobe SD,"1,875",6,3,9,0.48%
Westmoreland,107653203,Greensburg Salem SD,"1,240",15,6,21,1.69%
Westmoreland,107653802,Hempfield Area SD,"2,691",10,6,16,0.59%
Westmoreland,107654103,Jeannette City SD,471,8,3,11,2.34%
Westmoreland,107654403,Kiski Area SD,"1,722",7,5,12,0.70%
Westmoreland,107654903,Ligonier Valley SD,748,3,2,5,0.67%
Westmoreland,107655803,Monessen City SD,344,2,2,4,1.16%
Westmoreland,107655903,Mount Pleasant Area SD,935,5,4,9,0.96%
Westmoreland,107656303,New Kensington-Arnold SD,792,16,18,34,4.29%
Westmoreland,107656502,Norwin SD,"2,462",9,6,15,0.61%
Westmoreland,107657103,Penn-Trafford SD,"1,936",1,4,5,0.26%
Westmoreland,107657503,Southmoreland SD,843,6,2,8,0.95%
Westmoreland,107658903,Yough SD,934,6,1,7,0.75%
Wyoming,119665003,Lackawanna Trail SD,442,0,2,2,0.45%
Wyoming,118667503,Tunkhannock Area SD,"1,121",0,0,0,0.00%
York,112671303,Central York SD,"2,751",13,10,23,0.84%
York,112673300,Crispus Attucks CS,105,27,37,64,60.95%
York,112671603,Dallastown Area SD,"2,999",9,3,12,0.40%
York,112671803,Dover Area SD,"1,573",13,9,22,1.40%
York,112672203,Eastern York SD,"1,078",8,5,13,1.21%
York,112672803,Hanover Public SD,814,6,6,12,1.47%
York,112674403,Northeastern York SD,"1,795",7,9,16,0.89%
York,115674603,Northern York County SD,"1,543",8,3,11,0.71%
York,112675503,Red Lion Area SD,"2,365",14,8,22,0.93%
York,112676203,South Eastern SD,"1,185",7,4,11,0.93%
York,112676403,South Western SD,"1,943",7,9,16,0.82%
York,112676503,Southern York County SD,"1,465",7,3,10,0.68%
York,112676703,Spring Grove Area SD,"1,808",5,9,14,0.77%
York,115219002,West Shore SD,"3,611",19,14,33,0.91%
York,112678503,West York Area SD,"1,376",8,2,10,0.73%
York,189670676,York Academy Regional Charter School,229,0,0,0,0.00%
York,112679002,York City SD,"2,430",76,58,134,5.51%
York,112679107,York Co School of Technology,"1,675",0,3,3,0.18%
York,112679403,York Suburban SD,"1,479",2,1,3,0.20%